06070809
00000000
00000000
00000000
00000000
00000000
00000000
40000000